0000000000000
00100E1111010
0000111110010
0111100000000
0111100000010
011C000C10010
011C100110010
0011110110010
00P1111110010
0111111010110
0111101011100
0111101010110
0111101000000
0000000000000