NO ./src/textures/roc.xpm
SO ./src/textures/roc.xpm
WE ./src/textures/roc.xpm
EA ./src/textures/roc.xpm

C 225,30,0
F 220,100,0
C 225,30,0

11111111
10001001
10010001
101111N1
111  111