010011P10100111101001111010011110100111101001111
000111110100111101001111010011110100111101001111
000111110001111101001111010011110100111101001111
111100000001111101001111010011110100111101001111
1111000000011111010011110100111101C0111101001111
1100001111000011010011110100111101C0111101001111
11110011110000110100111101001111010C111101001111
011110111100001101001111010011110100111101001111
001111110011111101001111010011110100111101001111
111100001111000001001111010011110100111101001111
111100001111000001001111010011110100111101001111
110000111100001101001111010011110100111101001111
1111001111110011010011110100111101E0111101001111
011110110111101101001111010011110100111101001111
001111110011111101001111010011110100111101001111
000111110001111101001111010011110100111101001111
111100001111000001001111010011110100111101001111
111100001111000001001111010011110100111101001111
11000011110000110100111101001111010C111101001111
111100111111001101001111010011110100111101001111
01111011011110110100111101001111010011110100111111111
00111111001111110100111101001111010011110100111111111