0000000000000000000000000000000000000000000000000
0P111111111111111111111111111111111111111111111C0
0111111111111111111111111111111111111111111111110
0111111111111111111111C11111111111111111111111110
0111111111111111111111111111111111111111111111110
0111111111111111111111111111111111111111111111110
0111111111111111111111111111111111111111111111110
0111111111111111111111111111111111111111111111110
0111111111111111111111111111111111111111111111110
0111111111111111111111111111111111111111111111110
0111111111111111C11111111111111111111111111111110
0111111111111111111111111111111111111111111111110
0111111111111111111111111111111111111111111111110
0111111111111111111111111111111111111111111111110
0111111111111C11111111111111111111111111111111110
0111111111111111111111111111111111111111111111110
0111111111111111111111111111111111111111111111110
0111111111111111111111111111111111111111111111110
0111111111111111111111111111111111111111111111110
0111111111111111111111111111111111111111111111110
011111111111111111111111111111111111111111C111110
0001111111111111111111111111111111111111111111110
0E01111111111111111111111111111111111111111111110
0000000000000000000000000000000000000000000000000