0100EB11
00011111
11110000
11110000
11C000C1
11C10011
01111011
0P111111