00000000000000000000000000000
010011P101001110C100111101000
0C01111101001111C100111101000
0001111100011111C100111101000
0111000000011111C100111101000
0111000000011111C100111101000
0100001111000011C100111101000
0111001111000011C100111101000
0111101111000011C100111101000
0011111100111111C100111101000
0111000011110000C100111101000
0111000011110000C100111101000
01000011110000110100111101000
01110011111100110100111101000
01111011011110111100111E01000
01110011111100110100111101000
00000000000000000000000000000